30 30
200000300001013000101000000010
100000000010020000300002000300
000110002000100000000002201400
000200110200401200000010300200
100000000000000300000000000000
000000000000120000210300020000
000000000000000000000003000100
000010001100000000000000002000
000000100000000041000000000000
000000003000000000000003000201
000401000000000001001030000000
010001000000000120000003003000
000000000100000001000000000000
401020000000010400000000000021
000000000110030300000002000000
000000022020100100000100023000
020000000000301000002002000000
000400000400010100000000003020
000032000001010231000220200000
000000000000000010200000010000
000030000300200000010000000000
000000100000023020000000003020
000000000000000000000030000301
100001000000000000010000000002
000202200000000000000000000004
200000000000000000000000000020
010000000000000030000100000102
030010400000020001000030001001
031100010000000001000000000100
000110000001030000000000010000
4848484848484848484848484848484848484849484848484848484848484848484848484849
48484848484848484848484848484848484849484848484848484848484848484848484848484848484848484848484848484948484848484848484848484948484848484848494948484948494848484848484849484848484848484848484848484848
49484849484848484848484848484848484848484848484848484848484848484848484848484848484848484848484849494848484848484849484948484849484848484848484848484948484849484848484848484848484848484848484849484848
48484848484849484849484848484848484848484848484948484848484848484849484848484848484848484849484848484848484848484848484848484848484849484848484848484848484848484848484848494848484949484848484848494848
48484848484848484848484849484848484948484848484848484949484848484848494848484848484848494948484848494848484948484848484848484848484848484848484848484848484848484848484848484848484848484848484848484848
48484848484848484848484848484848484848484848484848484848494848484848484848484848484848484848484848484848484848484848484848484848484848484848494848484849484848484848494948494848484848484848484848484848
48484848484848484848484848484848484848484848484849484848484848484848484948484848484848484848484848484848484948484849484848484849484848484849484848494848484848484848484948484848484848484948484848484849
48484848484848484848494948484848484848484849484848484848484848484848484848484848484948494948484848484848484848484848484848484848484848484948484848484848484948484848494848484848484849484848484849484848
48484848484849484848484848484848484848484848484948484848494948484848484848484848484848484849484848484948484848484848484848484848484848484848484848494848484948484848484948484848484849484848484848484848
49484848484848484848484848484848484848484848484848484848484848484848494849484848484848484848484848484848484848484848494848484848484848484848484848484848484948484848484848484848484848494848484848484848
48484848484848484848484849484849494848484848494849484848484948484848494948484848484848484849494848484848484848484848484848484848484848484849484948484848484849484848484848494848484848484948484948484848
48494848484948484848484849484848484848484949484849484848494848484848484848484848484848484848484848484848484848484848494849484848484848484849484848484848484849494848484848484848484848484848484848484848
49484848484848484848484848484848494948484848484848484848484848484848484848484849484849494848484848494848484848494848484848484848484848484848484848484848484848484848484848484848484848484848484848484848
48484848484848484948484848484948484848484948484849484849484848484848494948484848484848484848484848484849484848484849484849484848484848484848484948484848494948484848484848484848494848484848484848484848
48494848484848494849484848484848484848484848484849484848484849484848484848494848484848484848484948484848494848484949484848484848484848484848494848484848484848494948484848494848484848484848484848484848
48484848484948484848484848484948484848484848484848484848484848484848484848484848484849484849494848494848484848484848484948484848484848484848484848484848484848484848484848484848484848484848484848484848
48484848484849484848484848484948484848484948484848484848484848484849484848484848484848484848484848494848484848484848484849484848494848484848484848484848484848484848484848484849484948484848484848484848
48484948484848484848494848484848484848484848484848494848484848484849484848484848484848484848484848484849484848484948484848484849484848484848484848484848484848484848484848484848484848484948484848484848
48484848484848484948484848484848484848484849484848484848484848484848484848484848484849494848484848494848484848484848484948484848494848484848484848484848484848484948484848484848484848484848494848484848
48484848484848484848484848484849484848484848494848484848484848494848484848484849484849494848484848484848484848484848484848484848484848484848494848484848484848484848484848484848484848484848484848484948
48484849494948484948484848484848484848484848484848484848484848484849484848484848484948484848484848484848484848484848484848484848484849484848484848484849484948484848484849484848484848484948484848484849
48494848484848484848484948484848484948484848484849484848484848484848484948484848484849484848484949484948484848484848484848494848484848484848484848484848484848484848484848484848484848484848484848484848
49484848484848484848484848484848484848484848484848484848484848484848484848484848484849484848484848484848484848484848484848484848484848484848484848484848484848484848484948494848494848484848484848484848
48484948484848484948484849484848484848484848484848484848484848484848484848484848484848484848484848484848484848484848484848484848484849484848484848484849484848484848484848484849494948484848494848494848
48484848484848484848484848484848484848484848484848484848484848484848484848484848484848494848484949484848484848484848484848484848484848484848484848484848494848484848494848484848484848484848484848484849
49484848484848484848484848484848484849484848494848484848484848484848484849484848494848484848484848484848484849484848494948484848484848484848484848484848484848484848484848484848484848484848484848484848
48484848484848494848484848484848484948484848484848494848494848484948484848484848484848484848484849484848484848484948484848494848484848484848484849484848484848484848484848484848484848484848494848494848
48484849484849484848484848484848484848484848484848484848484848484948484848484848484848484848484848484849484848484848484848484848484848484848484848484848484948484848494848484848484848484848484848484848
48484848484848484848494848484848494848484848484848484848484848484849484848484848484848484848484848484848484948484848494848484848484848484848484848484848484849484848484848484848484849484848484848484848
48484848484848484848484848484848484848484848484848484848484848484848484949484848484848494848494948484848484848484848494848484848484848484848484848484848484848484848484848484848484848484848484848484848
49484848484848484848484848484849494848484848484848484848484848484848484848484848484848494848484848484848484848484848484848484848484848484849484848484848494848484848484848484848484848484849484848484848
48484848484848484849484848484948484848484848484848484848494848484848484848484848484848484948494848494848484848484848484848484848484848484848484848484948484848484848484848484848484848484848494848484948
48484848494848484848484848484848484948484848484848484848484848484848484848484848484849484848494848484849484848484948484849484848484848484848484848484848484848484848484848484848484848484849484848484848
48484848484848484848484948484848484848484848484848484948484848484848484848484949484848484848484848484948484848484848484848484848484848484848484849484849484848484848484848484848494849484848484848484848
49484848484848484848484848484948484849484848484848484848484848484848484848484848484848484848484848484848484848484848484848484848484848484848484848484848484848484848484849494848484848484948484848484848
48484848484848484848484848484848484848484848484848484849484848484848484848484848494848484848484849484948484848494948484848484948484848484848494848484848484848484848484948484848484848484848484848484849
48484848484848484848484848484848484848484848484848484848494848484848484949484848484848484848484848484848484848484848484848484848484848484848484948484848484848484848484849494948484848484848484848484848
48484848484849484848484848484848494848484848484848484948484848484948484848484848484848484848484848484848484849484848484849484848484848484848484848484848484848484849484848484848484848484849484848484848
48484849484848484849484848484848484849484848484848484848484848484948484849484848484948484848484848484848484848484848484948484848484848484848484848484848484848484848484848484848484848484848484848484848
48484848484848484848484848484949484848484848484848484848484848484848484848484948494849484848484849484848484949484948484948484848484848484848484848484848484848484848484848484848484848484848484948484848
48484848484948484848484848484848484849484848484848484848484848484848484848494848494948484849484948484848484848494948484848484848484848484848484848484848484848484848484848494848484948484848484848484848
48484849494848484848484848484848484848484848484849484848484848494849484849484848484848484848484948484849484848484949484848484848484848484848484849484848484848484848484848484848484848484948484848484848
48484948484848484848484848484848484848484848484948484848484849484848484849484848484848484848494848494848484848494848484948484848484848484848484848484848484849484848484848484848484848484849494848484848
48494848484848494848484848484948484848484848484848484848484848484848484948484948484848484848484848484849484848484849484848484848484848484848484848484848484848484848484848484848484848484848494848484848
48484848494848484848484848484848484848494948484848484848484848484848484848484848484848484848484848484848484849484848484948484848484848484948484948484848484848484848484848484848484848484948484948484848
48484848484848484849484848494848484848484848484848494948484848484848484848484948494848484848484848494849484848484849494848484848484848484848484848484848484848484848484848484848484848484848484848484848
48484848494848484848484849484848484848484848484848484848484848484848484848484848484848494848484848484848484848494848484848484848484848484849484848484849494848484848484849484848484848484848484848494848
49484848494848484949484848494848484848494848484848484848484848484848484848484848484848484848484848484848484848484948484849484848494948484849484848494848484848484848484849484848494848484848484848494848
48484848484848484848484848484848484848484948484848484948484848484848484848484848484848484948484848484848484848484848484848484848484848484848484848484848484848484848484848484848484848484948484848484848
48484848484848484848484848484848484848494848484848484948484848484849484848484848484848494848484848484948494848484848484848484848494848484848484848484848484848484848494848484849484848494848484948484849
48484848484848484848484848484948484848484848484848484848484848484849484848484849484848484848484848484848484848484848484848484848484848484848484848484849484848484848484848484848484848484948484848484848
48494848484848484848484848484848484848484849484848484848484848484849484849484848484948484948484848484848484848484848484848484848494848484848484848484848494948484848484848484848484848484848484848484849
48484949484848484848484849484848484848484848484848484848484848484848494949484848484848484848484848484848484849484848494848484949484848484849484848484848494848484848494849484848484948484848484848484849
48484848484848484848484848484848484848484948484849484848494848494848484948484848484948484848484948484848494848484849484848484848484848484849494848484848484848484848484848484848484848484848494848494849
48484848494848484849484848484848484848484848484848484848484948484849484848484848484848494848484848484848494848494848484848484849494848484848484948494848484848484848484848484848484848484948484948484848
48484848484848484848484848484848484848484848484848494849484848494948484848484848484848484849484848484848484848484848484848484849484848484849484848484848484848484848484848484848484848484848484848484848
48484848484848484848484848484948484849484848484848484948484848484848484848494848484848484849484848484848484848484848484848484848484948484848484848484848484848484848484848484848484848484848484848484848
48484849484848484848484848484848484849484848484849484848484848484848484848484848484848484848484848484848484848484848484848484848484848484848494848484848484848494848484848484848484848484848484848484848
48484848484949484848484848484848484848484848484848484848494848484848484849484848484848494849484848484848484848484848484848484848484948484848484848484849484848484849484848484848484848484848484848484848
48484848484848484848484848484848484848484848484848484848494848494848494848484848484848484848484848494848494848484848484948484848484848484848484948484848484848484848484848484848484849484848484849484848
48494948484848484848484848484948484848484848484848484848484949484848484948484848484849484848484848484848484848484848484848484848484848484848484848484848484848484848484848484848484848484848484848484848
48484948484848484848484848484848494848494848494848494848484848484848484848484848484848484848484848484848484848484848484848484849494848484848484848484848484848484848484848484848484849484848484948484848
48484848484848484848484848484848484848484848484848484848494848484848484848484848484848484848484848484848484948484848484848484848494948484849484948484848484848484848484848494848484848484848484848484848
48484848484948484848484948484848484848484848484848484848484848484848484848484848484848484848484848484948484848484848484948484848484848484849484848484848494848484848484848484848484848484848484948484848
48484848484848484848484848484848484848484848484848484948484848484848484848484848484848484848484848484848484848484848484848484848484848484848484848484848484848484849484848484948484848484848484848484848
48494849484848494848484848484848484948484848484848484848484848484948484848484848484848484948494848484848484848484848484848484848484848484848484848484848484848484848484848484848484848494848484848484848
48494848484848484848484848484848484848484848484848494848484849484848484848494948484848484848484948484849484848484848484848484948484848484948484848484849484848494848484848484848484848484849484848484848
48484848484848484948484848484848494848484849484848484848484848484849494848484848484848484848484848484848484848484848484848484848484848484848494948484849484848484848484848484848484848484848484848484848
48484848484848484848494848484848494848484848484848494848494849484849484848484848484848484948484848484848484848484849484848484948484849484849484849484848484848484848494849484848494849494848484848484848
48484848484948494848484848484948484848484848494848484848484849484849484848484849494848494948484948484848484848484848484849494848484948484848484848484848484848484848484849484849484848494849484848484848
48484848484848484948484848484848484848494848484848484849494848484848484948484848484849484848494848484848484848484848484848484848494848484849484848484848484848484848484848494848484849484848484848484848
48484848494848484849494848484848484848484848484848484848484848494848484848484848484948484849484848484848484848484848484848484848484848484848484848484848484848494848484848484848494848484848484848484848
49484848484848484948484849484948484848484848484848484848484848484849484848484848484948484848484948484848484848484848484848484848484848484848484848484848484948484848484849484848484848484948484848484848
48484848484848484848484848484848484848484848484848484848484848484848484849484849484848484848484848484848484848484848484848484848494848484848484848494848484849484848484849484848484848484848484848484848
48484948484848484948484848484848484848484848484848484849484848484848484848484848484848484848484948484848484849494948484848484848484848484848484848484848484849484848484848484848484848484848484848484948
48484948484848484948484848484849484848484848494848484848484849484848484848484848484848484848484948494848494848484849484849484848494848484848484849484848484848484848484848494948484849494848484848484948
48484848484848484948484848484848484948484848484848494848484849484848484848484849484848484848484848484948484848484848484948484848484848484848484848484848484848484848484848484848484848484848484848484848
48484848484848484849484848484848484848484848484848484848484848484948484848484848484848494848484848484848484849484848484848484848484848484848484848484848484848484848484848484948484848484848484848484848
48484848484848484948484848484848484848494848484848484848484848484848484848484848484848484848484848484948484848484848484848484848484848484848484848484848484848484848484848484848484848484848484848484848
49484848484848484849484848484848484848484849494848484848484849484848484848484948484848484848484948484948484848494848484848484848484848484848484948484849484848484848484848484848484848484848484848484849
48484848484848484848484848484848484849484848484848484848484848484849484848484848494848484848484848484848484848484849494948484848494948484848484848484848494849484848484848484848484848484848484848484848
48484948484948484848484848484848484848484948484848484848484848484848484848484848484848484848484849484848484848484848484848484848484848484848494848484848484849484848484848484848484848484849484848484849
48484848484848484848484849484948484848484948484848484848484848484848484848484848484848484848484848484848484848484848484848484848484848484849484848484848484848484848494848484848484848484848484848484849
48484848484848484848494848484848484849484848484848494848484849484848484849484848484848484848484848484848484948484849484848484948484848484848484948484848484848484848484848484948484848484848484848484848
48484848484848484848484848484848484848484848484848484948484848484848484848484848484848484848484848484848484848484848484848494848484848484848484848484849484848484849484848484848484948494848484848484948
48494848484948484849484848494848484948494948484849484848494848484848484848494949484848484848484848484849494848484848484848484849484848484948484848484848484848484848484848484848484848494848484849484848
48484848484848484848494848484848484848494948484848484849484848484848484848484848484848484848484848484848494848494848484848484848484848484948494848484848484948484848484848484848484848484848484848484848
48484849494848484848484848484848494848484848484848484848484848484848484848484848484848484848484848484848484848484849484848484848484848484848484948484848484848484848484848484848484848494848484948484848
48484848484848484848484848484848484848484848484848484848484849484849484848484849484948484848484848484848484848484848484848484848484848484848484848484848484848484948484848484848484848494848484848484848
48484848484848494848494848484848484848484848484948494848484848484848484848484848484848484848484848484948494848494848484848494949484848494848484848484848494848484848484848484848484948484848484849484848
48484848484848484848484848484848484848484848484848484848494848484848484848484849484848484848484848484848484848484848484848484848484848484848484848484848484848494848484848484849484848484848484848484848
48484848484848494948484848494848484848484849484848494848484848484849484848484848484848494848484848484848494848484848484848484848484849484848484948494849484848484849484948484848494848484848484848484848
48494848494948484848484848484849484848484948484848484848484848484848484848484849484848484848484849484848484848484848494948484848484948484848484948484848484848484848484849484848484848484848484848484848
48484848484848484948484948484848484848484848494848484848484849484848484848484948484848484848484848484848484848484848484848484848484848484848484848484848494848484848494848484848484848484848484848484848
48484848484848494948484948484848484848484848484848484848484848484949494848484848484848484948484848484848484848484948484848484948484848484848484848484848484848484848484848484848484848484848494848484948
48484848484848484948484948494848484848484848494848484848484849484948484848484848484848484849484848484848484848484948484848484848484848484948494848484848484848484848484848484848484848494848484848484848
