30 30
000000001000000000100100000000
002100011000000100100000200000
000110200000000010000010000000
000000000000000000000110000000
000000000000220000000000000002
100100000400020010000001010100
000000001000020021000001000000
002000300000000000001000000000
003040000101000200000000003200
000000100000000012100010030000
000012200100000100003200000040
030000004000000000100001000001
000000002000000000000000010000
000000010000000301000000002002
000000000000000000000000000000
000000000020000000000031010003
000100100200010011000010000100
000004000000001200010000200300
000000230100003000201000000000
000003001004010020000200000020
000102000000000001100000000030
000030001000002000010000000001
000000000000100000000000000000
001002000000404000010200000000
000000200010000000000001100100
000020000000020010000002001000
000000000000010030000101000000
000020000100001000000000003000
000000000200103000000000100010
102000000000000002200010201000
