30 30
000400000030000100100000020031
000000000000300000000200000200
000000000000000002012100000001
300000000000112000020000020010
002000000000101002000000000000
000010000000000000000000000000
102003000010000000000000400000
000000000101001001000010001000
000020000000000000000000100020
000000030020000041003000000001
010000010200000000000000000100
310000002000020000000000000000
200000000131203000000010000203
000000000010000010100300000000
000400000010000000000000000003
100000000002000500000130100000
000000010200020100000000000000
000100000000000000000000000000
000001000000000000000000200000
021020000001000001000000000000
000040000000000000001002000000
000000020000000000000000000000
000010000020000004002000000000
003000040202000200000000000002
030000200020200100100000401001
000000000000200004000100000000
000030000000000000010000001000
000000000000000000101110000100
000200000040000100000000000000
200200000000240030001004000010
00300000000000020000000000000
02000000000000002200010201000
