30 30
110000000010000000000000000210
001000300000010300100000000000
100203000120100000000000000100
001000000000000001003000000100
000000000010000000021000000000
000000002000000010000000000000
202000020000010020000010000000
000100004200011000000000010000
001000000000000200100000101010
000000000200000210000001000120
000000000300000000002002100000
010001000000000000200000200100
033200002000000000020000000000
010000010000000000410000100000
000002000000202000000000000000
022000000020000000202000001000
300030000000040000000001010000
000000020002200000010000000000
000000000010000000013100000000
000000000030000030000012000000
000000000100001000000200130004
000100000100000000000000100000
200000000100000000001010010000
013000000010010100000000221000
000000000000000000010000000000
000000014000000000020100001200
400000004000000000000002000000
000001000200000002102003000000
301004000010000001000010001120
000300000000000020000000000000
02000000000000002200010201000
