30 30
300000000002100000000000000000
000000000000000000000000000000
000000100200000000100001022000
000000000101040010000000000000
102001000000000002020001000000
000000000110000000003000000030
000000000000010000000000000100
000002000000000000000000040000
000000010000000200002002220100
100000000200000000000000000000
010300000002000000000000000000
001000010001100040000000000000
000010000010000001000000001004
103000102000001000000003000200
200000000000000000000130010000
300300001301000510100002000000
000120000000302110000000000000
120000000100300000000100210000
000010000100000000000000004300
000000100200000000001300000000
001000000000000000000000100000
000100000000010000000004200000
020000000000300000200001100001
000000001001000100100200200000
030003000000000000000000004000
000100010000100004000000000000
000000001000010000020200000200
000000000012000040200000000000
200000001000000000000001000000
000000100010001400200000000000
00200000000240030001004000010
00300000000000020000000000000
02000000000000002200010201000
