30 30
002000000200004001000004000001
001010000000000001021000100000
002000000001000000001000000100
000310000000000000030000000000
200000001000000010002001000000
000000000000000000300100000000
000040000000000010000000000021
010000001001000000000200000000
000000010000030000011000001000
000000000010100000010000001000
011000001000000000000100000001
000000101101000000000001000000
002110000000300000002024001000
000000011001010000000000000000
000000001100000000120001000100
000000001000000500000100000100
000000000001000001000000000000
000001000010000031001000000300
000010010000200000002200102010
020000000001000020000000000001
000002000000000120000000000021
100000001000010001000111000200
000100000120002000100001000001
010010013000000000202000021000
000000000000000100000040100032
004000000201000000100020002000
001010000000100202000000000000
000000100001000300000000000000
000001000400000010000000010000
000000000001000000030000000000
00300000000000020000000000000
02000000000000002200010201000
